R 1800000 180000

NO ./pics/bluestone.xpm
SO ./pics/eagle.xpm
WE ./pics/redbrick.xpm
EA ./pics/purplestone.xpm

S ./pics/pillar.xpm

F 100, 255, 0
C 0,100, 255

        11111111111 1111111111111
        10000000001 1000000000001
        1011000001110000002000001
        1001000000000000000000001
111111111011000001110000000000001
100000000011000001110111111111111
11110111111111011100000000001
11110111111111011101010000201
11000000110101011100000010001
10002000S00000001100000010001
10000000010000001101010010001
11000001110101011111011110001
11110111 1110101 101111010001
11111111 1111111 111111111111


